1248 1312 120 1 64 64 300 8
1824 896 65 1 64 64 300 8
1920 1312 65 1 64 64 300 8
2848 768 65 1 64 64 250 8
3680 256 65 1 64 64 300 8
4096 256 65 1 64 64 300 8
4512 256 65 1 64 64 300 8
5600 256 65 1 64 64 300 8
6464 480 65 1 64 64 300 8
6560 480 65 1 64 64 250 8
6624 480 65 1 64 64 300 8
6688 480 65 1 64 64 300 8
6752 480 65 1 64 64 300 8
6848 480 65 1 64 64 300 8
6912 480 65 1 64 64 300 8
7008 480 65 1 64 64 300 8
7104 480 65 1 64 64 300 8
6368 160 65 1 64 64 300 8
6912 160 65 1 64 64 300 8
1996 1325 65 1 64 64 300 8

