1248 1312 115 2 64 64 300 8
1888 896 115 0 64 64 300 8
1920 1312 115 0 64 64 300 8
2720 832 115 0 64 64 300 8
3456 640 115 0 64 64 300 8
4000 640 115 0 64 64 300 8
4416 224 115 0 64 64 300 8
4384 640 115 0 64 64 300 8
6048 1312 115 0 64 64 300 8
6496 1344 115 0 64 64 300 8
7488 928 115 0 64 64 300 8
7296 1344 115 0 64 64 300 8
7680 1344 115 0 64 64 300 8
8224 1344 115 0 64 64 300 8
8640 1344 115 0 64 64 300 8
8288 992 115 0 64 64 300 8
9728 1344 90 2 64 64 300 8
10304 1344 90 2 64 64 300 8
199600 132500 65 1 64 64 300 8
