7104 384 70 2 64 64 300 8
6976 128 65 17 64 64 300 8
6848 384 70 2 64 64 300 8
6720 128 65 17 64 64 300 8
6624 384 70 2 64 64 300 8
6144 128 65 17 64 64 300 8
5984 384 70 2 64 64 300 8
5472 256 65 17 64 64 300 8
4864 256 65 17 64 64 300 8
4544 256 65 17 64 64 300 8
4096 256 65 17 64 64 300 8
4000 256 70 2 64 64 300 8
3712 256 65 17 64 64 300 8
3552 864 65 17 64 64 300 8
4896 960 70 2 64 64 300 8
5056 960 65 17 64 64 300 8
4672 1184 70 2 64 64 300 8
4160 1184 65 17 64 64 300 8
4576 1504 70 2 64 64 300 8
4800 1504 70 2 64 64 300 8
5120 1472 65 17 64 64 300 8
5504 1504 0 17 64 64 300 8
199600 132500 65 1 64 64 300 8
