896 352 120 1 64 64 300 8
1952 160 65 0 64 64 300 8
2592 256 65 1 64 64 300 8
3136 256 65 1 64 64 300 8
3680 256 65 1 64 64 300 8
4096 256 65 1 64 64 300 8
4512 256 65 1 64 64 300 8
5600 256 65 1 64 64 300 8
6464 480 65 1 64 64 300 8
6560 480 65 1 64 64 300 8
6624 480 65 1 64 64 300 8
6688 480 65 1 64 64 300 8
6752 480 65 1 64 64 300 8
6848 480 65 1 64 64 300 8
6912 480 65 1 64 64 300 8
7008 480 65 1 64 64 300 8
7104 480 65 1 64 64 300 8
6368 160 65 1 64 64 300 8
6912 160 65 1 64 64 300 8
1996 1325 65 1 64 64 300 8

